6 5 4 2 3 4 
1 5 3 2 1 3 
6 5 3 3 4 3 
3 5 4 5 2 4 
5 4 6 3 4 3 
2 5 5 4 3 6 
1 2 6 2 5 1 
2 6 2 4 3 2 
3 2 3 4 2 5 
4 4 3 2 2 1 
