45
3 4 3 4 3 2 
4 3 1 1 5 3 
1 4 2 2 1 3 
5 4 5 1 4 3 
2 1 1 4 4 2 
3 3 3 5 5 1 
2 5 5 4 1 2 
4 5 4 6 6 4 
3 5 5 2 6 6 
6 6 5 1 2 6 
