10
3 1 7 1 6 6 
4 4 1 3 4 6 
3 1 6 4 3 1 
1 6 3 3 4 6 
1 4 2 7 5 5 
3 1 3 1 5 3 
6 3 5 6 3 2 
1 2 1 3 5 5 
6 6 3 5 1 4 
3 2 4 3 3 4 
