40
2 2 4 1 6 4 
2 3 3 6 4 5 
5 1 2 3 5 5 
4 2 2 2 3 6 
2 5 6 4 2 2 
3 5 1 2 4 5 
6 6 4 5 5 6 
5 6 5 1 3 4 
6 3 1 6 3 2 
4 4 5 1 6 1 
